1111111111111
1P0000000C00E
1111011111011
1C00000000001
1111111111111