1111111
1P0C001
1111011
100E001
1011011
1C00001
1111111