1111111111
1P0000C001
1110111011
100E100001
1011111011
1000000001
1011111111
1C00000001
1000000001
1111111111