111111111
1P00C0001
111101111
100E1001
1C0000001
111111111