11111111
1P0000E1
11110101
10000001
1C111101
10000001
10111111
11111111