1111111111111
10X10000X00C1
1000011111X01
1P0011E000001
10X00000C0001
1111111111111
