1111111111111111111111111111111111
1E000000C000C00C00000C000C000CC001
101001010010C000101001000CCC010101
1010010010101010001001000000010101
1P0000000C00C000C00CCC00C0000C00C1
1111111111111111111111111111111111