111111111111
1P0011111101
1C0000000001
111011111101
100E10000001
101111111111
100000000001
111111111101
100000000001
1C0011111101
100000000001
111111111111